3 6 13
AAAAAABBBBBBB 
AAAAAABBBBBBA 
BBBAAABBBBBAA 
BBAAAABBCCAAA 
BBBBBABACCCAA 
BBBBBBAAAAAAA 
